#.####...#..#....#.#..##..##.....#.##..#....#.....
......#...........#.##.....#.#.##...#..#....#.#...
#..........#....#..#...#.###........#.....#..#.#..
..##.#...#..####.........##.........##....#.#.#.#.
.....##.#.#....#...#..####.#.#..#..........##..#.#
.##..#.#.##....#..#.....#.......###..#.....#...##.
..#...#....#.###......#..##....#.#...#...#.....#..
#........#.#.#.#.###....##........#.....###......#
....#......###...##.#.....#.#.##.#..#.#....#...#..
####.#$.##...#.##....#..#...........#...#.#....##.
...#.#.##..........#....#..#..#.##....#....#......
##......##.......#...#..###.#..#..........#.##....
.##....#...##..##.....#.....##.........##....#.#..
.#.###.#.....#................#.###.#...##...###.#
.....#..#..#.#.......#......#...####..#.###.#.....
#.#.#..........##.#....#...............#......#.#.
##..#..##.#....#.........#....#..#.........#..#...
..###.##.#..###.....##....#..###.##.#....###.##...
@#...###...#...#...#..#.#.##.#..#.#...........#..#
..#..#.....#...#....#.......#.....#.#.....#.##....
