##..#...#..#....#..#.......##.#..#..#....#..#...#.
.###.#..###..#..##...#.#.#......##..#....#.#..#...
.......#..###..##..###...#....#..#....#..#...#....
...#.##..#...##.#...#.....#...##..##..#....##.....
..#..#.......#.#.......#.#....#....#..###.....#...
.##.........##.#.......#..##....##....#....####...
.#..#.....#..#.#...#.##.............#.#.##......#.
...#.#..##...#..#........##..##..#........#.#..#.#
.###.#.#..###.#....#........##...##.....#.......#.
.##.#..#..##....#...##........##.....#..#.#....#..
..#..........#...##..#####.##..#.##......#...#..#.
.####..#............#..#..###..#.##....#.#.#.#....
#....#.###.##.#.#....#............#..#.##...#.....
.##....#.#.....###.#..#.....##.#......#.##....#...
##..##....#.#.#........#..........##.#..##.#...#.#
....#...................##...##.##.......#.....##.
.#.#.....#...###..#....#.....#.....#......#.#.....
...###.#...##.......#.#...#...#..#.##...####.#.##.
@#.###.#...#......##..#...##.##......#..#.#.#..#..
###.###.....###...#..#.##....#....#..####..###.##.
